#number before level = size of level WIDTH HEIGHT, with a scale of 1 for 20 pixels, P = player, F = fly ennemy, T = turret enemy, B = boss, H = boss heart, K = tank, 1 = health bonus, 2 = damage bonus, 3 = triple shot
100 30
XXXXXXXXXXXXXXXXXXXXXXXXXXXXXXXXXXXXXXXXXXXXXXXXXXXXXXXXXXXXXXXXXXXXXXXXXXXXXXXXXXXXXXXXXXXXXXXXXXXX
XXXXX            XXXXXX                XXXXXXXX                 XXX           XX             XXXXXXX
X                                                                 T                                X
X                                                                                                  X
X                                                                                                  X
X                                                                                                  X
X  P                                                                                               X
X                                                                           F F F  F               X
X                             F F F  F                                                             X
X                                                                                                  X
X                                                                           K                      X
X  P                                                                                               X
X                                                                                                  X
X                                    F F F                             F F F F                     X
X                                                                                                  X
X                                                                                                  X
X                                                                                                  X
X  P                                                                                               X
X                                                                                                  X
X                                                F  F F                                            X
X                                                                                                  X
X  P                                                                                               X
X                                                                                                  X
X                                                                                                  X
X                                                                                                  X
X                                             T T                                     T            X
X                                                                                                  X
X                                            XXXXX                                    XX           X
XXXXXXXXXXX                      XXXX X X XXXXXXXXX              XXX                XXXX     XXXXXXX
XXXXXXXXXXXXXXXXXXXXXXXXXXXXXXXXXXXXXXXXXXXXXXXXXXXXXXXXXXXXXXXXXXXXXXXXXXXXXXXXXXXXXXXXXXXXXXXXXXXX
211 30
XXXXXXXXXXXXXXXXXXXXXXXXXXXXXXXXXXXXXXXXXXXXXXXXXXXXXXXXXXXXXXXXXXXXXXXXXXXXXXXXXXXXXXXXXXXXXXXXXXXXXXXXXXXXXXXXXXXXXXXXXXXXXXXXXXXXXXXXXXXXXXXXXXXXXXXXXXXXXXXXXXXXXXXXXXXXXXXXXXXXXXXXXXXXXXXXXXXXXXXXXXXXXXXXXXX
XXXXXX            XXXXXX                XXXXXXXX                 XXX                 XX             XXXXXXXXXXX            XXXXXX                XXXXXXXX                 XXX                 XX             XXXXXX
X                                                                                                                                                                                                                 X
X                                                                T                  T               T T T T                T  T                  T  T T                  T                                        X
X                                                                                                                                                                                                                 X
X                                                                                                                                                                                                                 X
X                                                                     T                                   H                                                                                                       X
X  P                                F F F F F                                                                                                       F F F F                                                       X
X                                                                     T         1                                                                                                                                 X
X                                                                                                                                                                                                                 X
X                                                                T                                   H                                                                                                            X
X                                                        F F F F                1                                                                                                                                 X
X  P                                                             T                                                                 F F F F F                                                                      X
X                                                                                                                                                                                                                 X
X                                   F F F F                         3                                                                                                                                             X
X                                                                               1                                                                                                                                 X
X                                                                                                        B                     F F F F F                                                                          X
X  P                                                                                                                                                                                                              X
X                                                         F F F F               1                                                    F F F F F                                                                    X
X                                                                                                                                                                                                                 X
X                                                                T                                   H                                                                                                            X
X  P                                F F F F                                                                                                                                                                       X
X                                                                T                   F F F F                                                  F F F F                                                             X
X                                                                     T                                   H                                                                                                       X
X                                                                                                                                                                                                                 X
X                                             T T                     T                   T                                                                                                                       X
X                                                                                                                                                                                                                 X
X                                            XXXXX                 T                     XX                                                  T           T T                                                      X
XXXXXXXXXXXX                      XXXX X X XXXXXXXXX              XXX                   XXXX     XXXXXX    XXXXXXXXXXX                      XXXX X X XXXXXXXXX              XXX                   XXXX     XXXXXX X
XXXXXXXXXXXXXXXXXXXXXXXXXXXXXXXXXXXXXXXXXXXXXXXXXXXXXXXXXXXXXXXXXXXXXXXXXXXXXXXXXXXXXXXXXXXXXXXXXXXXXXXXXXXXXXXXXXXXXXXXXXXXXXXXXXXXXXXXXXXXXXXXXXXXXXXXXXXXXXXXXXXXXXXXXXXXXXXXXXXXXXXXXXXXXXXXXXXXXXXXXXXXXXXXXXX
100 30
XXXXXXXXXXXXXXXXXXXXXXXXXXXXXXXXXXXXXXXXXXXXXXXXXXXXXXXXXXXXXXXXXXXXXXXXXXXXXXXXXXXXXXXXXXXXXXXXXXXX
XXXXX            XXXXXX                XXXXXXXX                 XXX           XX             XXXXXXX
X                                                                 T                                X
X                                                                                                  X
X                                                                                                  X
X                                                                                                  X
X  P                                                                T                              X
X                                                                           F F F  F               X
X                            F F F  F              K                 T                             X
X                                                                                                  X
X                                                                     T                            X
X  P                                                                                               X
X                                                                      T                           X
X                                    F F F                        K    F F F F                     X
X                                                                                                  X
X                                                                       T                          X
Xv                                                                                                 X
X  P                                                                     T                         X
X                                                F  F F                   T                        X
X                                                                                                  X
X  P                                                                       T                       X
X                                                                                                  X
X                                                                           T                      X
X                                                                                                  X
X                                                                                                  X
X                                             T T                                     T            X
X                                                                                                  X
X                                            XXXXX                                    XX           X
XXXXXXXXXXX                      XXXX X X XXXXXXXXX              XXX                XXXX     XXXXXXX
XXXXXXXXXXXXXXXXXXXXXXXXXXXXXXXXXXXXXXXXXXXXXXXXXXXXXXXXXXXXXXXXXXXXXXXXXXXXXXXXXXXXXXXXXXXXXXXXXXXX
